NO textures/wallno.png
SO textures/wallso.png
WE textures/wallwe.png
EA textures/wallea.png

C 143,194,244
F 222,184,135

111111111111111111111111111
1N0000000000000000000000001
100000000000000000000000001
110000000000000100000000001
100000000000000000000000001
100010000000001000000000001
100000001000000000001000001
100000000001000000000000001
100000000001000000000000001
100000000000000000000000001
100000000000000000000000001
111111111111111111111111111