NO textures/wallno.png
SO textures/wallso.png
WE textures/wallwe.png
EA textures/wallea.png
DO textures/door.png

C 143,194,244
F 222,184,135

111111111111111111111111111111111111
1N0000000000000000000000000000000001
100000000000000000000000000000000001
100000000000000000000000000000000001
100000000000000000000000000000000001
100000000000000000000000000000000001
100000000000000000000000000000000001
100000000000001111111111111111111111
10000000000000D000000000000000000001
100000000000001111111111111111111111
100000000000000000000000000000000001
1D1000000000000000000000000000000001
101000000000000000000000000000000001
101000000000000000000000000000000001
101000000000000000000000000000000001
101000000000000000000000000000000001
111111111111111111111111111111111111